00 00 00 00 00 00 00 00
00 00 00 00 00 00 00 00
00 00 00 00 00 00 00 00
4f 19 40 00 00 00 00 00
03 64 86 25 00 00 00 00
55 19 40 00 00 00 00 00
dc 17 40 00 00 00 00 00
