65 65 65 65 65 65 65 65
65 65 65 65 65 65 65 65
65 65 65 65 65 65 65 65
65 65 65 65 65 65 65 65
05 18 40 00 00 00 00 00
33 18 40 00 00 00 00 00
